5
#####  
#BW.#  
#...#  
#wb.#  
#####  